111111111111111
101000000000001
101010100000001
101000000000001
101111000000001
100000000000001
101010111000001
100100000000001
101100000000001
101000000000001
101000000000001
101000000000001
101100000000001
100000000000001
111111111111111