1111111111111111111111111
1000000000000000000000001
1100000000000000110000011
1000011111100011111100001
1000000110000000000000001
1000000110000000000000001
1000000110000000001100001
1000001111000000001100001
1000000000000000001100001
1000011000000011111100001
1000111100000011000000001
1000111100000011000000001
1000011000000010000000011
1000000000000000000001111
1000000000111000000001111
1111111111000000000000011
1111000000000000000000001
1110001111001110000000001
1100001110011110000111001
1000001110001110000010001
1000001111001110000000001
1100000000000000000000011
1000000000000000000000001
1111111111111111111111111